5 7
| | . | | | .
| . . . . . .
| . | . | . |
. . . . | . |
| | | . | | |
0 6
3 0
